=================================// 08 Oct 2022

1. falter: to become weak or move in a way that is not steady
           		अशक्त होना या अस्थिर होना; लड़खड़ाना

2. onset: the beginning (often of something unpleasant)
			आंरभ (प्रायः किसी अप्रिय स्थिति का)

3. projections: a guess about a future amount, situation, etc. based on the present situation
			वर्तमान स्थिति के आधार पर भविष्‍य की बातों (धनराशि, स्थिति आदि) का अनुमान

4. peg/pegging: to fix or keep something at a certain level
			वस्‍तु को एक विशेष स्‍तर पर स्थिर बनाए रखना

5. nadir: the worst moment of a particular situation
			स्थिति विशेष का सबसे बुरा समय

6. derail: पटरी से उतार देना
7. outlook: दृष्टिकोण, संभावना
8. benign: kind or gentle, not dangerous
9. laid out: to arrange in a pattern or design; to plan something by showing how its parts fit together.
			Ex:- The designer laid out the book with pictures on every page.

10. gloomier: sad and without much hope
11. cite/citing: उदाहरण या प्रमाणस्‍वरूप किसी बात का उल्‍लेख करना या किसी व्‍यक्ति के मूल शब्‍द उद्धृत करना
12. uptick: a small increase or slight upward trend.
13. dent/denting: किसी वस्‍तु की समतल सतह को चोट मारकर पिचका देना
14. sit out: not take part in a particular event or activity.
			Ex:- he had to sit out Sheffield Wednesday's cup game

15. reckon: मानना, समझना; किसी विषय में कोई विचार होना/ मोटे तौर पर कोई हिसाब लगाना
16. gung-ho: unthinkingly enthusiastic and eager, especially about taking part in fighting or warfare.
			Ex:- the gung-ho tabloids have wrapped themselves in the Union Jack

17. ingenious: चतुराई से बनाया गया या सोचा गया, कौशलपूर्ण, कुशल
18. cumbersome: मुश्किल, पेचीदा.
19. abstention: तटस्‍थता
20. province: one of the areas that some countries are divided into with its own local government
			Ex:- देश का कोई प्रांत या प्रदेश जो स्‍वायत्तशासी होता है या अपना शासन स्‍वयं चलाता है

21. annexation: दूसरे देश को अपने देश में बलपूर्वक मिलाने की गतिविधि; समामेलन
22. catastrophic: कष्‍टकारी
23. peril: गंभीर ख़तरा, संकट
24. adherence: निष्‍ठा, समर्थन
25. defiance: (किसी का) आदेश मानने से साफ़ इनकार; खुली अवज्ञा
26. sovereignty: the power that a country has to control its own government
			 Ex:- राष्‍ट्र की स्‍वयं अपना शासन चलाने की शक्ति; संप्रभुता, प्रभुसत्ता

27. abstain: to stop yourself from doing something that you enjoy
			Ex:- अपने को संयम में रखना; परहेज़ करना

		 (in a vote) to say that you are not voting either for or against something
			Ex:- (मतदान में) भाग न लेना; तटस्‍थ रहना

28. irk: to irritate or annoy somebody
29. fawning: displaying exaggerated flattery or affection; obsequious.
30. exaggerated: अतिशयोक्तिपूर्ण


==============================// 09 Oct 2022

31. overhaul: to look at something carefully and change or repair it if necessary

32. pulled up: to stop

33. stricture: a restriction on a person or activity

34. deterrent: something that should stop you doing something

35. tenable: able to be defended against attack or criticism

36. excipients: substances used alongside active ingredients

37. sternly: कठोरतापूर्वक

38: inept: not able to do something well
			Ex:- कोई काम अच्‍छे ढंग से करने में असमर्थ; दक्षताहीन, अकुशल 

39: hushed up: to keep quiet

40. crack down on: take severe measures against someone or something.

41. merry: happy or slightly drunk

42. unscrupulous: being dishonest, cruel or unfair in order to get what you want

43. frantic: extremely worried or frightened

44. indoctrination: मतारोपण

45. afloat: अच्‍छी आर्थिक स्थिति में होना

46. maxim: कहावत

47. draconian: excessively harsh and severe.

48. intrude : to enter a place or situation without permission or when you are not wanted

49. unleashed upon: to free from

50. charade: झूठी स्थिति या घटना जिसमें लोग दिखावे का व्‍यवहार करते हैं

51. commie: communist

52. slumber: to be deeply asleep
			Ex:- गहरी नींद सोना, नींद, झपकी

53. herstory: history viewed from a female or specifically feminist perspective.

54. laureate: a person who has been given a high official honour or prize for something 
			important they have achieved in a particular field

55. canon: a generally accepted rule, standard or principle by which something is judged
			स्‍वीकृत नियम, मापदंड या सिद्घांत जिससे किसी वस्‍तु का मूल्‍यांकन होता है
				Ex:- the canons of good taste

	     a list of books or other works that are generally accepted as the genuine work of a particular writer or as being important
			किसी लेखक की मान्‍यता दिलाने या महत्वपूर्ण पुस्‍तकों, लेखों आदि की प्रमाणित व सर्वस्वीकृत सूची
				Ex:- the Shakespeare canon

56. rung: सीढ़ी का डंडा जिस पर पैर रखते हैं

57. ethnologist:?

57: harrowing: लोगों को दुखी या परेशान कर देने वाला; उत्‍पीड़क
			Ex:- The programme showed harrowing scenes of the victims of 
				the war.The programme showed harrowing scenes of the victims of the war.

58. manifestly: सुस्‍पष्‍ट रूप से

59. cartel: a group of separate companies that agree to increase profits by fixing prices and not 
		competing with each other

60. grapple: व्‍यक्ति या वस्‍तु को पकड़कर उससे लड़ना या उसे क़ाबू में करने की कोशिश करना


===========// Vocab 3rd jan 2023

shudder = ज़ोर से काँपने लगना (विशेषतः अमंगल की भावना या विचार से)
tantrum = a sudden explosion of anger, especially by a child
chortle = laugh in a noisy, gleeful way
statutory = क़ानून द्वारा निर्धारित; सांविधिक
abrogation = निराकरण, removal or cencellation.
netizen = someone who uses the Internet a lot
flaunt = to show something that you are proud of so that other people will admire it (किसी बात पर इतराना - ताकि दूसरे लोग भी तारीफ़ करें )
reiterate = दुहराना, बार बार कहना
uphold = किसी निर्णय आदि का समर्थन करना 
confluence = संगम
Drain the swamp = Drain the swamp is a metaphor that means to root out corruption
wreak = किसी व्‍यकि्त या वस्‍तु को बहुत क्षति या हानि पहुँचाना
havoc = अत्‍यधिक विनाश या अव्‍यवस्‍था की स्थिति; विनाश
offensive = आक्रमण
hideouts = ठिकानों
deterioration = स्थिति में गिरावट, पतन, ह्रास
stern = कठोर, बहुत गंभीर
resort = सहारा लेना
spurt = एकाएक रफ़्तार या कोशिश बढ़ा देना
plunge = ताक़त के साथ कहीं कुछ घुसाना (plunge the country back into a cycle of violence)
unfold = थोड़ा-थोड़ा करके प्रकट करना
province = the part of a country that is outside the most important city (the capital)
bolster = to support or encourage somebody/something; to make something stronger
coalition = दो या अधिक राजनीतिक दलों के सहयोग से बनी सरकार; गठबंधन सरकार
sortie = युद्ध के समय सैनिक विमानों द्वारा ली गई छोटी उड़ान
incursion = आकस्मिक हमला; छापा; घुसपैठ
insurgency = विद्रोह, बग़ावत
covert = गुप्‍त, छिपकर किया गया
Simp = a silly or foolish person.
souvenir = निशानी
refrain = to stop yourself doing something
irony = विडंबना
raze = (भवन, शहर आदि) पूर्णतः नष्‍ट कर देना; ध्‍वस्‍त करना
oversee = किसी काम पर निगाह रखना (कि वह ठीक से हो), निरीक्षण करना
ascertain = कुछ पता लगाना
subsidence = sinking of the ground because of underground material movement
grim = गंभीर,अप्रिय या चिंताजनक
Allurement = fascination; charm
desist = stop doing something; cease or abstain.
amici curiae = friend of the court.
tirade = लंबा, क्रोधपूर्ण, निंदात्मक भाषण
solicitor = क़ानूनी परामर्श देने, क़ानूनी दस्‍तावेज़ तैयार करने, ज़मीन ख़रीदवाने और बिकवाने आदि का काम करने वाला वकील
rechristen = give a new name to.
deliberate = योजनानुसार
dubious = संदिग्‍ध
brace = स्‍वयं को अप्रिय स्थिति के लिए तैयार करना

================================// 29 January 2023 //========================================
cynic = व्‍यक्ति जो सबको स्‍वार्थी समझता हो; दोषदर्शी
crouch = सिकुड़ कर बैठना 
instilling = किसी के मन में कुछ बैठाना, की शिक्षा देना (to make somebody think or feel something)
padding = बिना आवाज़ किए चलना क्‍योंकि जूते नहीं पहने हैं
hail = व्‍यक्ति या वस्‍तु की सार्वजनिक रूप से प्रशंसा करना
affluent = धनवान, समृद्घ
craning = कुछ देखने या सुनने के लिए गरदन बाहर को निकालना, उचकाना
shook = (shake) हिलना, हिलाना
clumsy = लापरवाह और बेढंगे तरीक़े से काम करने वाला; फूहड़, भद्दा
soggy = बहुत गीली और नरम
bout = a short period of great activity
frown = ऐसे क्रोध प्रदर्शित करना कि माथे पर रेखाएँ दिखाई देने लगें; भौंहें तन जाना, त्‍योरी चढ़ना
shrug = कंधे उचकाना (‘Who knows?’ he said and shrugged.)
tip-off = (पुलिस आदि को प्राप्‍त) गुप्‍त सूचना (संभावित अपराध के विषय में)
rift = दरार 


Test text



